"filename", "language", "Dart", "comment", "blank", "total"
"c:\Users\alexp\OneDrive\Class\TFG\FlutterFrontEnd\my_app\lib\api_service.dart", "Dart", 88, 4, 18, 110
"c:\Users\alexp\OneDrive\Class\TFG\FlutterFrontEnd\my_app\lib\custom_drawer.dart", "Dart", 99, 1, 3, 103
"c:\Users\alexp\OneDrive\Class\TFG\FlutterFrontEnd\my_app\lib\main.dart", "Dart", 39, 8, 7, 54
"c:\Users\alexp\OneDrive\Class\TFG\FlutterFrontEnd\my_app\lib\main_screen.dart", "Dart", 670, 52, 83, 805
"c:\Users\alexp\OneDrive\Class\TFG\FlutterFrontEnd\my_app\lib\navigation_origin.dart", "Dart", 4, 0, 1, 5
"c:\Users\alexp\OneDrive\Class\TFG\FlutterFrontEnd\my_app\lib\past_flights.dart", "Dart", 81, 0, 7, 88
"c:\Users\alexp\OneDrive\Class\TFG\FlutterFrontEnd\my_app\lib\photo_gallery.dart", "Dart", 61, 0, 8, 69
"c:\Users\alexp\OneDrive\Class\TFG\FlutterFrontEnd\my_app\lib\select_flight.dart", "Dart", 135, 1, 7, 143
"c:\Users\alexp\OneDrive\Class\TFG\FlutterFrontEnd\my_app\lib\video_gallery.dart", "Dart", 89, 0, 12, 101
"Total", "-", 1266, 66, 146, 1478